NO ./path_to_the_north_texture


SO ./path_to_the_south_texture

EA ./path_to_the_east_texture
WE ./path_to_the_west_texture         
C 225,30,0


F 220,255,0
                           1
        1111111111111111111011111
        1000000000110000000000001
        11100000111001000000100111
        10010000000000000001 100001
1111111110110000011100000000100011
100000000011000001110111111111111
11110111111111011100000010001
11110111111111011101010010001
11000000110101011100000010001
10000000000000001100000010001   
11111111111111111111111111111
10111111111111111111110111111
11111111111111111111111111111   
10000000000000001101010010001
11000001110101011111011110N0111
101110111 1110101010111101000101
11111111 1111111111111111111111