NO ./path_to_the_north_texture
SO ./path_to_the_south_texture
EA ./path_to_the_east_texture
WE ./path_to_the_west_texture

F 220,100,0
C ,30,0

11111111111111111111111111
10000000001100000000000011
101100000111000100000S0011
10010000000000100000000011
11111111101100000111000001
10000000001100000111011111
11110111111111011100000011
11110111111111011101010011
11000000110101011100000011
10000000000000001100000011
10000000000000001101010011
11000001110101011111011111
11110111 1110101 101111011
11111111 1111111 111111111