NO ./texture/Brick09.png
SO ./texture/Brick10.png
EA ./texture/Brick11.png
WE ./texture/Brick12.png

F 255,255,255
C 0,255,255

111111111111111111111111
11111101D1D1D1D1D1D1D1D11
10000001D1D1D1D1D1D1D1D11
10000001D1D1D1D1D1D1D1D11
11D10001D1D1D1D1D1D1D1D11
100D0001D1D1D1D1D1D1D1D11
10010001D1D1D1D1D1D1D1D11
11111100000000000000000W111111111
111111111111111111111110D00000D001
                       11111D11001
                       11111110001
                       111111101D1
                       11111110001
                       11111111D11
                               1