NO ./texture/wall.png
SO ./texture/wall64.png
EA ./texture/wall.png
WE ./texture/wall64.png

F 138,17,13
C 0,0,0

11111111111111111111111111
10000000000000000000000001
10000000000000000000000001
10000000000000000000000001
1000000000D0W0000000000001
10000000000000000000000001
10000000000000000000000001
10000000000000000000000001
10000000000000000000000001
10000000000000000000000001
10000000000000000000000001
10000000000000000000000001
11111111111111111111111111