NO ./texture/my_texture.png
SO ./texture/my_texture.png
EA ./texture/wall.png
WE ./texture/wall64.png

F 138,17,13
C 0,0,0

1111111
1000001
1000001
11D1W01
100D001
1001001
1111111