NO ./texture/wall.png
SO ./texture/wall.png
EA ./texture/wall.png
WE ./texture/wall.png

F 138,17,13
C 0,0,0

11111111111111111111111111
10000000001100000000000011
10110000011100010000000011
10010000000000100000000011
11111111101100000111000001
10000000001100000111011111
11110111111111011100000011
11110111111111011101010011
11000000100101011100000011
100000000D0000001100000011
100000000N0000001101010011
11000001110101011111011111
11111111111111111111111111