NO ./path_to_the_north_texture
SO ./path_to_the_south_texture
EA ./path_to_the_east_texture
WE ./path_to_the_west_texture

F 255,255,255
C 0,0,0


1111111111
1000100001
1000000001
1000S00001
1000001001
1111111111
