NO ./texture/hel-magh.png
SO ./texture/wall64.png
EA ./texture/aoulahra.png
WE ./texture/wall.png

F 255,255,255
C 0,0,0

1111111111111111111111111
1000000000001000000000001
100000N000000100000000111
1111111111111111111111111