NO ./texture/Brick09.png
SO ./texture/Brick10.png
EA ./texture/Brick11.png
WE ./texture/Brick12.png

F 255,255,255
C 0,0,0

1111111111111111111111111
1000000000000000000000001
110000000000000000000000111
1100000000000000000000001
110000N00000010000000011111
1111111111111111111111111