NO ./texture/Brick09.png
SO ./texture/Brick10.png
EA ./texture/Brick11.png
WE ./texture/Brick12.png

F 255,255,255
C 0,0,0

1111111111111111111111111
1000000000000000000000001
10000000001D1000000000001
1000000000000000000000001
100000N000000100000000111
1111111111111111111111111